.......................
####################...
####################...
#####.....#.......##...
#####@...!|......^##...
#####.....#.......##...
####################...
####################...
.......................