.......................
####################...
####################...
#####?....#.......##...
#####@...!|......^##...
#####.....#.......##...
####################...
####################...
.......................