###############
#?....#.......#
#@...!|......^#
#.....#.......#
###############