######################################################
######################################################
######################################################
######################################################
####....!.................................###....#####
########|####################..!..###########...@#####
####........................#..............!.....#####
###########################!##########################
###########################|##########################
####...............!|....!..!|.........!.........#####
######!##################|############!###############
####.........!....!..........#E........|!........#####
######################################################
######################################################
######################################################
######################################################


