###############################################
###############################################
##############################..............###
##############################^.............###
##############################..............###
#####.....#.......##.......###########......###
#####@...!|...!...!|...!...##############|#####
#####.....#.......##.......##############!#####
####################.......####.............###
#######################!#######....!........###
#######################|#######.............###
###################........##############...###
###################....!...!|..........!|...###
###################........####################
###############################################