..............................................
########################################
########################################
#####.....#.......##...............#####
#####@...!|........................#####
#####.....#.......##...............#####
########################################
########################################
..............................................