######################################################
######################################################
######################################################
######################################################
####.................#.!..................###....#####
#######################|#####..!..###########...@#####
####........................#..............!.....#####
###########################!##########################
###########################|##########################
####...............!|....!..!|........!..........#####
#############|###########|############|###############
####.........!....!..........#E........!.........#####
######################################################
######################################################
######################################################
######################################################


